333333333333333333333333
300000000111100000000003
302222220000002222222203
302000022000222000000203
303000000000000000000303
302000022200222000000203
302000020000002000000203
302222220000002222222203
300000010000001000000003
300000000000000000000003
300000010000001000000003
300000000000000000000003
300000010000001000000003
302222220000002222222203
301000000000000001111103
301111100000000001111103
301111100000000000000103
301131111113111111311103
300000000000000000000003
333333333333333333333333